NO ./textures/path_to_north_texture.xpm
WE ./textures/path_to_west_texture.xpm
EA ./textures/path_to_east_texture.xpm
SO ./textures/path_to_south_texture.xpm

C 35,19,73
F 15,6,40

111111111111111
111111000111111
111110000011111
1111000N0001111
111000000000111
110000000000011
1000011111000011
110000111000011
1110000100001111
111100000001111
111110000011111
111111000111111
111111111111111
