NO ./textures/purple.xpm
WE ./textures/red.xpm
EA ./textures/blue.xpm
SO ./textures/grey.xpm

F 139,99,58
C 171,154,137

111111111111111
111111000111111
111110000011111
111100000001111
111000000000111
110000000000011
1000011111000011
110000111000011
1110000100001111
111100000001111
111110000011111
111111N00111111
111111111111111
