NO textures/path_to_north_texture
SO textures/path_to_south_texture
WE textures/path_to_west_texture
EA textures/path_to_east_texture

      FP 220,100,0
C 225,30,0


111111111111111111111111111111111111
100000000000000000000000000000000001
100000000000000000000000000000000001
100000000000000000000000000000000001
100000000000000000000000000000000001
100000000000000000000000000000000001
100000000000000010000000000000000001
100000000000000010000000000000000001
100000000000000010000000000000000001
100000000001111110000000000000000001
100000000001000000000000000000000001
100000000001000000000000000000000001
100000000001000000000000000000000001
100000000001111111111111110000000001
100000000000000000000000010000000001
100000000000000000000000010000000001
100000000000000000000000010000000001
100000000000000000000000010000000001
100000000000000000000000010000000001
100000011111111111111111110000000001
100000010000000000000000000000000001
100000010000000000000000000000000001
100000010000000000000000000000000001
100000011111111111111111110000000001
100000000000000000000000010000000001
100000000000000000000000010000000001
10000000000000000000000001000000N001
100000000000000000000000000000000001
111111111111111111111111111111111111