NO ./textures/purple.xpm
WE ./textures/red.xpm
EA ./textures/blue.xpm
SO ./textures/grey.xpm

F 20,20,20
C 200,200,200

11111111
1W000001
11111111