NO ./textures/path_to_north_texture.xpm
WE ./textures/path_to_west_texture.xpm
EA ./textures/path_to_east_texture.xpm
SO ./textures/path_to_south_texture.xpm

F 18,53,25
C 153,204,255

111111111111
111111111111
111111111111
111111111111
111110000001
10S00000000000000001
111111111111
110000000001
111111111111
111111111111
