NO textures/path_to_north_texture.xpm
SO textures/path_to_south_texture.xpm
WE textures/path_to_west_texture.xpm
EA textures/path_to_east_texture.xpm

F 20,20,20
C 200,200,200

111111
1 1N 1
111111