11111
1N001
10001
100E1
11111
